NO ./textures/wooden.xpm
SO ./textures/stone_wall.xpm
WE ./textures/stone_wall2.xpm
EA ./textures/390.xpm

F 125,182,109
C 216,255,255

111111111111111111111111111
100000000011000000100000111
101100000111000000000000111
1011000000000S0000000100111
111111111011000001110000111
100000000011000001110111111
111101111111110111000000001
111101111111110111010000001
110000001101010111000001001
100000000000000111000001001
100000000000000000000101001
110000011101000111110111001
111101111110101101111010001
111111111111111111111111111
